#####################################################################################################################################################################################
#                 #     #    X               #        #           #              #                 #              #                 #              #     #                          #
#                 #     #                    #        #           #              #                 #              #                 #              #     #                          #
####  ##########  #  #  #######  #######  #  #  ####  ####  ####  #  #  ##########  #######  ####  ####  #######  ##########  ####  ####  #######  ####  #  ##########  ##########  #
#     #     #     #  #        #  #        #  #     #        #  #  #  #     #              #     #        #     #     #        #  #     #     #  #  #     #  #        #           #  #
#     #     #     #  #        #  #        #  #     #        #  #  #  #     #              #     #        #     #     #        #  #     #     #  #  #     #  #        #           #  #
##########  #  ####  #######  ####  #######  ####  ##########  #  #  ####  #  ################  ##########  #######  #  #######  ####  ####  #  #  #  ####  #  ####  ##########  ####
#        #  #     #     #  #        #     #     #     #           #  #  #  #  #              #  #     #           #     #     #     #     #  #     #           #              #     #
#        #  #     #     #  #        #     #     #     #           #  #  #  #  #              #  #     #           #     #     #     #     #  #     #           #              #     #
####  #  #  ####  #  #  #  ##########  #  ####  #  #  #############  #  #  #  #  ##########  #  #  #  #  #######  #######  ####  #  ####  #  #  #######  ###################  ####  #
#     #  #     #  #  #  #           #  #     #  #  #  #              #  #     #     #           #  #           #        #        #     #     #  #     #  #        #           #  #  #
#     #  #     #  #  #  #           #  #     #  #  #  #              #  #     #     #           #  #           #        #        #     #     #  #     #  #        #           #  #  #
#  ####  #  ####  #  #  #  ####  ####  ####  #  ####  #  #############  ##########  #  ##########  ###################  #  ##########  #######  #  #  #  #  ####  ####  #######  #  #
#     #  #     #  #  #  #     #  #     #  #  #  #     #           #        #     #  #  #     #  #     #     #           #        #  #        #     #  #  #  #  #     #           #  #
#     #  #     #  #  #  #     #  #     #  #  #  #     #           #        #     #  #  #     #  #     #     #           #        #  #        #     #  #  #  #  #     #           #  #
####  #  ####  #  ####  ####  #  #  ####  #  #  #  #############  ####  ####  #  #  #  #  #  #  #  ####  #  #  ################  #  ####  #  #######  #  #  #  ####  ##########  #  #
#     #  #     #     #  #     #  #        #     #     #              #  #     #  #  #  #  #  #     #     #  #                 #  #     #  #  #        #  #  #     #     #     #  #  #
#     #  #     #     #  #     #  #        #     #     #              #  #     #  #  #  #  #  #     #     #  #                 #  #     #  #  #        #  #  #     #     #     #  #  #
#  ####  #  #  ####  #  #  ####  #######  #######  #  #  ##########  #  #  ####  #  ####  #  #######  ####  ####  ##########  #  ####  #  ####  ##########  ####  ####  #  #  ####  #
#  #     #  #  #  #     #     #        #  #        #     #     #  #  #     #     #        #              #     #           #  #     #  #        #           #     #  #     #        #
#  #     #  #  #  #     #     #        #  #        #     #     #  #  #     #     #        #              #     #           #  #     #  #        #           #     #  #     #        #
#  ####  #  #  #  #######  ####  ####  #  #  #############  #  #  #  ####  #  #######  ##########  ##########  ##########  #  ####  #  ##########  ##########  #  #  #############  #
#     #     #  #     #     #     #     #  #     #           #  #  #     #  #  #     #     #     #  #           #        #  #     #  #  #           #           #           #        #
#     #     #  #     #     #     #     #  #     #           #  #  #     #  #  #     #     #     #  #           #        #  #     #  #  #           #           #           #        #
#  #  #######  #  #  #  ####  #  #######  ####  #  ##########  #  ####  ####  #  #  #######  #  ####  ##########  ####  #  ####  #  #  #  #  ################  ##########  #  #######
#  #  #     #     #  #  #     #  #        #     #        #  #  #     #     #  #  #     #     #        #  #        #  #  #  #  #     #     #  #              #  #  #     #  #        #
#  #  #     #     #  #  #     #  #        #     #        #  #  #     #     #  #  #     #     #        #  #        #  #  #  #  #     #     #  #              #  #  #     #  #        #
#  #  #  #  ##########  #  #######  ##########  #######  #  #  #  #######  #  #  ####  #  ####  #######  #  #  ####  #  #  #  #############  #  ##########  #  #  #  #  #  #######  #
#  #     #              #  #        #        #     #  #  #     #        #     #  #        #     #     #     #  #        #  #                 #  #     #     #  #     #     #        #
#  #     #              #  #        #        #     #  #  #     #        #     #  #        #     #     #     #  #        #  #                 #  #     #     #  #     #     #        #
#  ######################  #  ##########  #  ####  #  #  #  ####  ####  ####  #  ################  #  ####  #  #######  #  #######  ##########  ####  #  ####  #############  #######
#  #        #           #     #        #  #     #     #  #     #     #     #  #                    #     #  #        #  #        #     #     #     #           #     #     #        #
#  #        #           #     #        #  #     #     #  #     #     #     #  #                    #     #  #        #  #        #     #     #     #           #     #     #        #
#  ####  #  #  #######  #######  #  #  #  ####  #######  ####  #######  #  #  #########################  #  #######  ##########  ####  ####  #  #  #######  ####  #  #  #  #######  #
#     #  #  #        #        #  #  #     #  #  #        #  #  #        #  #  #           #           #  #  #     #           #     #     #     #     #     #     #     #        #  #
#     #  #  #        #        #  #  #     #  #  #        #  #  #        #  #  #           #           #  #  #     #           #     #     #     #     #     #     #     #        #  #
####  #  #  #######  #  ####  ####  #######  #  #  #######  #  #  ##########  #  #  ####  #######  #  #  #  ####  ####  ##########  ####  #  #######  #######  #############  ####  #
#     #  #  #        #     #     #     #     #     #           #  #           #  #  #  #        #  #  #  #           #              #     #     #     #                    #  #     #
#     #  #  #        #     #     #     #     #     #           #  #           #  #  #  #        #  #  #  #           #              #     #     #     #                    #  #     #
#  ####  #  #  ##########  ####  #  #  #  ##########  ##########  #  #############  #  #######  #  ####  #######  #######  ##########  #######  #  ####  ###################  #  ####
#     #  #  #  #        #  #     #  #  #  #        #     #     #                    #  #        #     #  #     #  #     #     #     #     #     #        #                    #     #
#     #  #  #  #        #  #     #  #  #  #        #     #     #                    #  #        #     #  #     #  #     #     #     #     #     #        #                    #     #
####  #  ####  #  ####  #  ####  ####  #  #  ####  ####  #  #  ######################  #  ##########  #  #  #  ####  #  ####  #  #  #  #  ####  ##########  #############  #######  #
#  #  #        #  #     #     #        #     #  #     #     #  #                    #  #  #           #  #  #        #     #  #  #     #     #        #     #        #     #        #
#  #  #        #  #     #     #        #     #  #     #     #  #                    #  #  #           #  #  #        #     #  #  #     #     #        #     #        #     #        #
#  #  #######  ####  #######  ##########  ####  #  #  #######  #  ################  #  #  #  #  #  ####  #  #############  #  ####  #######  ##########  ####  #  ####  ####  #######
#  #        #        #     #  #     #        #  #  #  #        #  #        #     #  #     #  #  #  #     #     #     #     #     #        #        #     #     #        #     #     #
#  #        #        #     #  #     #        #  #  #  #        #  #        #     #  #     #  #  #  #     #     #     #     #     #        #        #     #     #        #     #     #
#  #######  ##########  #  #  #  #  #######  #  #  ####  #######  #  #######  #  #  #  #######  #  #  #######  #  #  #  #######  ##########  ####  #  ####  #############  #######  #
#        #              #  #     #  #     #  #  #              #  #        #  #  #  #  #        #  #     #     #  #  #  #        #        #  #     #  #                 #  #     #  #
#        #              #  #     #  #     #  #  #              #  #        #  #  #  #  #        #  #     #     #  #  #  #        #        #  #     #  #                 #  #     #  #
#  #  ###################  #  ####  #  #  #  #  #############  #  ####  #  #  #  #  #  #  #######  ####  #  ####  #  #  #######  #  ####  ####  ####  ################  #  #  #  #  #
#  #        #           #  #     #     #  #     #     #  #     #     #  #  #  #  #  #     #  #        #     #     #  #        #  #  #  #        #  #                 #  #     #     #
#  #        #           #  #     #     #  #     #     #  #     #     #  #  #  #  #  #     #  #        #     #     #  #        #  #  #  #        #  #                 #  #     #     #
#  ####  #  #  #  ####  #  ##########  #  #######  #  #  #  ####  #  ####  #  #  #  #######  #  ##########  #  ####  #######  #  #  #  ##########  #  #############  #  ##########  #
#  #  #  #  #  #     #  #           #  #  #        #  #     #     #     #  #  #  #  #           #        #  #     #  #     #  #  #  #           #     #        #  #  #           #  #
#  #  #  #  #  #     #  #           #  #  #        #  #     #     #     #  #  #  #  #           #        #  #     #  #     #  #  #  #           #     #        #  #  #           #  #
#  #  #  ####  ####  #  ##########  #  #  #  #######  #  ####  #######  #  #  #  #  #  ##########  ####  #  ####  #  #  #  #  #  #  #  #######  #  ####  #  #  #  #  ##########  #  #
#  #  #  #     #  #  #  #     #     #  #        #     #  #     #     #  #     #     #     #        #     #  #     #     #     #     #  #     #  #  #     #  #     #     #     #  #  #
#  #  #  #     #  #  #  #     #     #  #        #     #  #     #     #  #     #     #     #        #     #  #     #     #     #     #  #     #  #  #     #  #     #     #     #  #  #
#  #  #  #  ####  #  #  #  #  #  ####  #######  #  ####  ####  #  #  #  #  #######  #  ####  #######  ####  #  #########################  #  #  #  #  ####  ####  ####  #  #  #  #  #
#     #     #     #  #  #  #  #  #     #     #  #  #  #     #  #  #  #  #  #     #  #  #     #        #     #  #        #                 #  #  #  #  #     #     #     #  #     #  #
#     #     #     #  #  #  #  #  #     #     #  #  #  #     #  #  #  #  #  #     #  #  #     #        #     #  #        #                 #  #  #  #  #     #     #     #  #     #  #
####  #######  #  #  ####  #  #  #  ####  #  ####  #  ####  #  #  #  #  ####  #  #  ####  #######  ####  ####  #  #######  #  #############  #  #  ####  ##########  #############  #
#     #        #  #        #  #  #  #     #        #     #  #  #  #     #     #  #     #        #     #  #     #        #  #  #                 #     #     #        #     #        #
#     #        #  #        #  #  #  #     #        #     #  #  #  #     #     #  #     #        #     #  #     #        #  #  #                 #     #     #        #     #        #
#  ##########  #  ##########  #  ####  #############  ####  ####  #######  ####  ####  #######  ####  ####  ####  ####  #  #  #######  #############  ####  #  #######  #  #  #######
#     #        #  #        #     #     #        #        #     #  #     #     #  #     #        #  #        #  #  #  #     #        #        #     #  #     #  #     #  #     #     #
#     #        #  #        #     #     #        #        #     #  #     #     #  #     #        #  #        #  #  #  #     #        #        #     #  #     #  #     #  #     #     #
####  #  #  #######  #  #  #######  #  #  ####  #  ####  ####  #  #  #  #  ####  #  ####  #######  ##########  #  #  #############  #######  #  #  #  #  ####  #  #  #  ##########  #
#  #  #  #  #     #  #  #        #  #  #  #  #  #  #  #        #     #     #     #        #        #     #  #     #           #     #        #  #     #     #     #     #           #
#  #  #  #  #     #  #  #        #  #  #  #  #  #  #  #        #     #     #     #        #        #     #  #     #           #     #        #  #     #     #     #     #           #
#  #  #  ####  #  #  #  #######  #  ####  #  #  #  #  #############  #######  #############  ####  #  #  #  #  ####  #  ####  #  #############  #######  #  #############  #######  #
#     #        #     #  #     #  #        #  #  #     #           #  #        #              #        #     #  #     #  #     #                 #     #  #        #           #     #
#     #        #     #  #     #  #        #  #  #     #           #  #        #              #        #     #  #     #  #     #                 #     #  #        #           #     #
#  ##########  #######  #  #  #  ####  ####  #  ####  #  #######  ####  #######  #######  ####  ##########  #  #######  #  ######################  ####  ####  ####  #######  #  ####
#  #        #        #     #  #     #        #  #     #  #     #  #     #        #        #     #     #     #  #        #  #        #        #        #     #     #  #  #     #  #  #
#  #        #        #     #  #     #        #  #     #  #     #  #     #        #        #     #     #     #  #        #  #        #        #        #     #     #  #  #     #  #  #
#  #  ####  #  ##########  #  ####  #  #######  #  ####  ####  #  #  #############  #######  ####  #  #######  #  #######  #  ####  #  ####  #  ####  ####  ####  #  #  #  ####  #  #
#     #     #  #        #  #  #     #  #        #  #        #  #  #  #           #     #     #     #           #  #     #  #     #     #     #  #     #        #        #     #     #
#     #     #  #        #  #  #     #  #        #  #        #  #  #  #           #     #     #     #           #  #     #  #     #     #     #  #     #        #        #     #     #
#######  ####  #  ####  ####  #  #######  #######  #######  #  #  #  #  #######  ####  #######  ################  ####  #  #  #  #############  #  ####  ###################  #######
#     #  #     #  #  #  #     #        #     #              #  #     #     #           #     #  #                    #  #  #  #           #     #           #              #        #
#     #  #     #  #  #  #     #        #     #              #  #     #     #           #     #  #                    #  #  #  #           #     #           #              #        #
####  #  ####  #  #  #  #  ##########  ####  ################  ##########  #############  #  #  ###################  #  #  #  ##########  #  #############  #  ##########  ####  #  #
#     #     #  #  #  #     #        #     #           #        #           #              #  #           #           #     #           #     #           #  #  #        #     #  #  #
#     #     #  #  #  #     #        #     #           #        #           #              #  #           #           #     #           #     #           #  #  #        #     #  #  #
#  #######  ####  #  #######  ##########  ##########  #  ####  #  #  #######  #############  ##########  #  ##########  ######################  #######  ####  #  #  #######  ####  #
#                 #                                   #     #     #                       #                 #                                   #              #  #                 #
#                 #                                   #     #     #                       #         O       #                                   #              #  #                 #
#####################################################################################################################################################################################
