#############################
#                           #
#                      X    #
#       ############        #
#                  #        #
#                  #        #
O                  #        #
#                           #
#                           #
#############################
