##############
#            #
#   ######   #
#   #    #   #
X   #O       #
#   #    #   #
#   ######   #
#            #
##############
