####X####
#       #
# ##### #
# #   # #
# #   # #
# #   # #
# #   # #
# ##### #
#       #
####O####
