#####################################
#                                   #
#                                   #
#       #####################       #
#       #                O  #       #
#       #                   #       #
#       #                   #       #
#       #                   #       #
#       #                   #       #
#       #                           #
#       #####################       #
#                                   #
X                                   #
#####################################
