#####################################
#                                   #
#                                   #
#       #####################       #
#       #                X  #       #
#       #                   #       #
#       #                   #       #
#       #                   #       #
#       #                   #       #
#       #                           #
#       #####################       #
#                                   #
O                                   #
#####################################
