#############################
#                           #
#                           #
#       #############       #
#       #           #       #
#       #           #       #
#       # X                 #
#       #############       #
#                           #
O                           #
#############################
