#############################
#                           X
#                           #
#                           #
#                           #
#                           #
#                           #
#                           #
O                           #
#############################
