#############################
#                   #       X
#                   #       #
#                   #       #
#   ##########  #   #####   #
#   #       #   #           #
#           #   #           #
#   #       #   #           #
#####   #   #   #########   #
#       #           #       #
#       #           #       #
#       #           #       #
#####   #   #########   #####
#       #   #           #   #
#       #   #           #   #
#       #   #           #   #
#   #########   #########   #
#                           #
#                           #
O                           #
#############################
