#X############################################
#                                #  #        #
#                                #  #        #
#######  ####  ################  #  #  #  ####
#     #     #     #     #        #     #     #
#     #     #     #     #        #     #     #
####  ##########  #  ####  #######  #######  #
#  #  #           #  #     #              #  #
#  #  #           #  #     #              #  #
#  #  #  ##########  #  ####  #############  #
#  #  #  #           #     #     #        #  #
#  #  #  #           #     #     #        #  #
#  #  #  #  #############  #######  ####  #  #
#  #     #  #           #           #     #  #
#  #     #  #           #           #     #  #
#  #######  #  ####  ################  ####  #
#              #     #              #        #
#              #     #              #        #
################  ####  ####  ####  #######  #
#                 #     #  #  #     #        #
#                 #     #  #  #     #        #
#  ####  ##########  ####  #  #  ####  #######
#  #     #        #     #  #  #     #        #
#  #     #        #     #  #  #     #        #
#  #######  ####  ####  #  #  #  ##########  #
#        #     #  #     #  #  #  #        #  #
#        #     #  #     #  #  #  #        #  #
#  ####  ####  #  #  ####  #  ####  ####  #  #
#     #        #           #           #     #
#     #        #           #           #     O
##############################################
